"filename", "language", "Java", "comment", "blank", "total"
"c:\Users\ryanz\OneDrive - AUT University\Semester 2 2023\COMP603\Assignment\COMP603-Project\COMP603-Project\src\com\group20\resortproject\Controller.java", "Java", 6, 5, 5, 16
"c:\Users\ryanz\OneDrive - AUT University\Semester 2 2023\COMP603\Assignment\COMP603-Project\COMP603-Project\src\com\group20\resortproject\Main.java", "Java", 31, 20, 13, 64
"c:\Users\ryanz\OneDrive - AUT University\Semester 2 2023\COMP603\Assignment\COMP603-Project\COMP603-Project\src\com\group20\resortproject\MainPanel.java", "Java", 32, 28, 15, 75
"c:\Users\ryanz\OneDrive - AUT University\Semester 2 2023\COMP603\Assignment\COMP603-Project\COMP603-Project\src\com\group20\resortproject\Model.java", "Java", 4, 5, 4, 13
"c:\Users\ryanz\OneDrive - AUT University\Semester 2 2023\COMP603\Assignment\COMP603-Project\COMP603-Project\src\com\group20\resortproject\View.java", "Java", 5, 4, 3, 12
"c:\Users\ryanz\OneDrive - AUT University\Semester 2 2023\COMP603\Assignment\COMP603-Project\COMP603-Project\src\com\group20\resortproject\cafe\CafeCategories.java", "Java", 13, 11, 5, 29
"c:\Users\ryanz\OneDrive - AUT University\Semester 2 2023\COMP603\Assignment\COMP603-Project\COMP603-Project\src\com\group20\resortproject\cafe\CafeController.java", "Java", 12, 16, 6, 34
"c:\Users\ryanz\OneDrive - AUT University\Semester 2 2023\COMP603\Assignment\COMP603-Project\COMP603-Project\src\com\group20\resortproject\cafe\CafeModel.java", "Java", 40, 16, 12, 68
"c:\Users\ryanz\OneDrive - AUT University\Semester 2 2023\COMP603\Assignment\COMP603-Project\COMP603-Project\src\com\group20\resortproject\cafe\Item.java", "Java", 45, 35, 15, 95
"c:\Users\ryanz\OneDrive - AUT University\Semester 2 2023\COMP603\Assignment\COMP603-Project\COMP603-Project\src\com\group20\resortproject\cafe\Order.java", "Java", 61, 52, 20, 133
"c:\Users\ryanz\OneDrive - AUT University\Semester 2 2023\COMP603\Assignment\COMP603-Project\COMP603-Project\src\com\group20\resortproject\cafe\OrderItem.java", "Java", 39, 0, 14, 53
"c:\Users\ryanz\OneDrive - AUT University\Semester 2 2023\COMP603\Assignment\COMP603-Project\COMP603-Project\src\com\group20\resortproject\equipment\EquipmentType.java", "Java", 19, 0, 6, 25
"c:\Users\ryanz\OneDrive - AUT University\Semester 2 2023\COMP603\Assignment\COMP603-Project\COMP603-Project\src\com\group20\resortproject\equipment\RentalEquipmentController.java", "Java", 18, 0, 8, 26
"c:\Users\ryanz\OneDrive - AUT University\Semester 2 2023\COMP603\Assignment\COMP603-Project\COMP603-Project\src\com\group20\resortproject\equipment\RentalEquipmentModel.java", "Java", 83, 0, 22, 105
"c:\Users\ryanz\OneDrive - AUT University\Semester 2 2023\COMP603\Assignment\COMP603-Project\COMP603-Project\src\com\group20\resortproject\equipment\RentalItem.java", "Java", 41, 0, 12, 53
"c:\Users\ryanz\OneDrive - AUT University\Semester 2 2023\COMP603\Assignment\COMP603-Project\COMP603-Project\src\com\group20\resortproject\gui\Navigator.java", "Java", 64, 54, 22, 140
"c:\Users\ryanz\OneDrive - AUT University\Semester 2 2023\COMP603\Assignment\COMP603-Project\COMP603-Project\src\com\group20\resortproject\gui\Page.java", "Java", 77, 51, 15, 143
"c:\Users\ryanz\OneDrive - AUT University\Semester 2 2023\COMP603\Assignment\COMP603-Project\COMP603-Project\src\com\group20\resortproject\gui\components\Heading.java", "Java", 36, 0, 12, 48
"c:\Users\ryanz\OneDrive - AUT University\Semester 2 2023\COMP603\Assignment\COMP603-Project\COMP603-Project\src\com\group20\resortproject\gui\components\TopBar\TopBarButton.java", "Java", 14, 0, 7, 21
"c:\Users\ryanz\OneDrive - AUT University\Semester 2 2023\COMP603\Assignment\COMP603-Project\COMP603-Project\src\com\group20\resortproject\gui\components\TopBar\TopBarController.java", "Java", 12, 0, 8, 20
"c:\Users\ryanz\OneDrive - AUT University\Semester 2 2023\COMP603\Assignment\COMP603-Project\COMP603-Project\src\com\group20\resortproject\gui\components\TopBar\TopBarView.java", "Java", 79, 11, 23, 113
"c:\Users\ryanz\OneDrive - AUT University\Semester 2 2023\COMP603\Assignment\COMP603-Project\COMP603-Project\src\com\group20\resortproject\gui\components\cafe\ItemPanel.java", "Java", 29, 0, 18, 47
"c:\Users\ryanz\OneDrive - AUT University\Semester 2 2023\COMP603\Assignment\COMP603-Project\COMP603-Project\src\com\group20\resortproject\gui\components\cafe\OrderPanel.java", "Java", 75, 0, 30, 105
"c:\Users\ryanz\OneDrive - AUT University\Semester 2 2023\COMP603\Assignment\COMP603-Project\COMP603-Project\src\com\group20\resortproject\gui\controllers\HomeController.java", "Java", 18, 0, 8, 26
"c:\Users\ryanz\OneDrive - AUT University\Semester 2 2023\COMP603\Assignment\COMP603-Project\COMP603-Project\src\com\group20\resortproject\gui\controllers\LoginController.java", "Java", 53, 3, 16, 72
"c:\Users\ryanz\OneDrive - AUT University\Semester 2 2023\COMP603\Assignment\COMP603-Project\COMP603-Project\src\com\group20\resortproject\gui\controllers\RegisterController.java", "Java", 85, 1, 27, 113
"c:\Users\ryanz\OneDrive - AUT University\Semester 2 2023\COMP603\Assignment\COMP603-Project\COMP603-Project\src\com\group20\resortproject\gui\controllers\WelcomeController.java", "Java", 20, 0, 11, 31
"c:\Users\ryanz\OneDrive - AUT University\Semester 2 2023\COMP603\Assignment\COMP603-Project\COMP603-Project\src\com\group20\resortproject\gui\controllers\cafe\CafeMainController.java", "Java", 40, 0, 13, 53
"c:\Users\ryanz\OneDrive - AUT University\Semester 2 2023\COMP603\Assignment\COMP603-Project\COMP603-Project\src\com\group20\resortproject\gui\controllers\creditpass\CreditController.java", "Java", 43, 0, 15, 58
"c:\Users\ryanz\OneDrive - AUT University\Semester 2 2023\COMP603\Assignment\COMP603-Project\COMP603-Project\src\com\group20\resortproject\gui\controllers\creditpass\CreditPassController.java", "Java", 20, 0, 9, 29
"c:\Users\ryanz\OneDrive - AUT University\Semester 2 2023\COMP603\Assignment\COMP603-Project\COMP603-Project\src\com\group20\resortproject\gui\controllers\creditpass\LiftPassController.java", "Java", 50, 11, 14, 75
"c:\Users\ryanz\OneDrive - AUT University\Semester 2 2023\COMP603\Assignment\COMP603-Project\COMP603-Project\src\com\group20\resortproject\gui\controllers\rentalequipment\RentalViewController.java", "Java", 22, 0, 8, 30
"c:\Users\ryanz\OneDrive - AUT University\Semester 2 2023\COMP603\Assignment\COMP603-Project\COMP603-Project\src\com\group20\resortproject\gui\views\LoginView.java", "Java", 119, 20, 33, 172
"c:\Users\ryanz\OneDrive - AUT University\Semester 2 2023\COMP603\Assignment\COMP603-Project\COMP603-Project\src\com\group20\resortproject\gui\views\MainMenuView.java", "Java", 85, 14, 16, 115
"c:\Users\ryanz\OneDrive - AUT University\Semester 2 2023\COMP603\Assignment\COMP603-Project\COMP603-Project\src\com\group20\resortproject\gui\views\RegisterView.java", "Java", 133, 16, 26, 175
"c:\Users\ryanz\OneDrive - AUT University\Semester 2 2023\COMP603\Assignment\COMP603-Project\COMP603-Project\src\com\group20\resortproject\gui\views\RentalEquipmentView.java", "Java", 121, 0, 41, 162
"c:\Users\ryanz\OneDrive - AUT University\Semester 2 2023\COMP603\Assignment\COMP603-Project\COMP603-Project\src\com\group20\resortproject\gui\views\ViewPanel.java", "Java", 13, 0, 7, 20
"c:\Users\ryanz\OneDrive - AUT University\Semester 2 2023\COMP603\Assignment\COMP603-Project\COMP603-Project\src\com\group20\resortproject\gui\views\WelcomeView.java", "Java", 52, 14, 12, 78
"c:\Users\ryanz\OneDrive - AUT University\Semester 2 2023\COMP603\Assignment\COMP603-Project\COMP603-Project\src\com\group20\resortproject\gui\views\cafe\CafeMainView.java", "Java", 114, 15, 37, 166
"c:\Users\ryanz\OneDrive - AUT University\Semester 2 2023\COMP603\Assignment\COMP603-Project\COMP603-Project\src\com\group20\resortproject\gui\views\creditpass\CreditPassView.java", "Java", 71, 14, 24, 109
"c:\Users\ryanz\OneDrive - AUT University\Semester 2 2023\COMP603\Assignment\COMP603-Project\COMP603-Project\src\com\group20\resortproject\gui\views\creditpass\CreditView.java", "Java", 70, 9, 21, 100
"c:\Users\ryanz\OneDrive - AUT University\Semester 2 2023\COMP603\Assignment\COMP603-Project\COMP603-Project\src\com\group20\resortproject\gui\views\creditpass\LiftPassView.java", "Java", 66, 9, 19, 94
"c:\Users\ryanz\OneDrive - AUT University\Semester 2 2023\COMP603\Assignment\COMP603-Project\COMP603-Project\src\com\group20\resortproject\lifts\Lift.java", "Java", 47, 0, 15, 62
"c:\Users\ryanz\OneDrive - AUT University\Semester 2 2023\COMP603\Assignment\COMP603-Project\COMP603-Project\src\com\group20\resortproject\lifts\LiftController.java", "Java", 7, 0, 4, 11
"c:\Users\ryanz\OneDrive - AUT University\Semester 2 2023\COMP603\Assignment\COMP603-Project\COMP603-Project\src\com\group20\resortproject\lifts\LiftModel.java", "Java", 33, 0, 9, 42
"c:\Users\ryanz\OneDrive - AUT University\Semester 2 2023\COMP603\Assignment\COMP603-Project\COMP603-Project\src\com\group20\resortproject\lifts\LiftPass.java", "Java", 36, 22, 12, 70
"c:\Users\ryanz\OneDrive - AUT University\Semester 2 2023\COMP603\Assignment\COMP603-Project\COMP603-Project\src\com\group20\resortproject\lifts\LiftPassModel.java", "Java", 53, 0, 20, 73
"c:\Users\ryanz\OneDrive - AUT University\Semester 2 2023\COMP603\Assignment\COMP603-Project\COMP603-Project\src\com\group20\resortproject\user\User.java", "Java", 90, 0, 27, 117
"c:\Users\ryanz\OneDrive - AUT University\Semester 2 2023\COMP603\Assignment\COMP603-Project\COMP603-Project\src\com\group20\resortproject\user\UserController.java", "Java", 47, 13, 17, 77
"c:\Users\ryanz\OneDrive - AUT University\Semester 2 2023\COMP603\Assignment\COMP603-Project\COMP603-Project\src\com\group20\resortproject\user\UserModel.java", "Java", 98, 0, 31, 129
"c:\Users\ryanz\OneDrive - AUT University\Semester 2 2023\COMP603\Assignment\COMP603-Project\COMP603-Project\src\com\group20\resortproject\utility\DBManager.java", "Java", 24, 1, 7, 32
"c:\Users\ryanz\OneDrive - AUT University\Semester 2 2023\COMP603\Assignment\COMP603-Project\COMP603-Project\src\com\group20\resortproject\utility\Tuple.java", "Java", 9, 0, 2, 11
"c:\Users\ryanz\OneDrive - AUT University\Semester 2 2023\COMP603\Assignment\COMP603-Project\COMP603-Project\src\com\group20\resortproject\utility\ValidationException.java", "Java", 6, 0, 1, 7
"Total", "-", 2480, 470, 797, 3747